[0, 0, 0, 0, 0, 0, 0, 0, 0, 0, 0, 0, 0, 0, 0, 0, 0,12],
[0, 0, 0, 0, 0, 3, 0, 0, 0, 3, 0, 0, 3, 0, 0, 3, 0, 0],
[0, 0, 3, 0, 0, 0, 0, 8, 0, 0, 0, 0, 0, 0, 0, 0, 0, 0],
[0, 0, 0, 3, 0, 0, 0, 0, 0, 0, 0, 0, 0, 0, 0, 0, 0, 0],
[0, 0, 0, 0, 0, 3, 0, 2, 2, 0, 0, 0, 0, 0, 0, 0, 0, 0],
[0, 0, 0, 0, 3, 0, 0, 1, 1, 0, 0, 0, 3, 0, 0, 0, 0, 0],
[0, 0, 0, 3, 0, 0, 0, 1, 1, 4, 4, 4, 4, 4, 4, 4, 0, 0],
[2, 2, 2, 2, 2, 2, 2, 2, 2, 2, 2, 2, 2, 2, 2, 2, 2, 2],
[1, 1, 1, 1, 1, 1, 1, 1, 1, 1, 1, 1, 1, 1, 1, 1, 1, 1],